e- : abessif (état)
ei- : privatif (relation)
ey- : pegatif (alignement morphosyntatique)
fo- : orientatif (état)
iŗ- : adessif (emplacement)
la- : locatif (emplacement)
li- : ablatif (mouvement depuis)
łe- : ablatif (relation)
ma- : pertigent (emplacement)
ne- : apudessif (emplacement)
nwo- : subessif (emplacement)
pa- : nominative (alignement morphosyntatique)
ţu- : génitif (relation)
še- : prolatif (mouvement via)
ßa- : délatif (mouvement depuis)
ßta- : superessif (emplacement)
te- : agentif (alignement morphosyntatique)
to- : sociatif (relation)
ţu- : génitif (relation)
vwo- : antessif (emplacement)
xelje- : distributif (relation)
žu- : perlatif (mouvement via)
-at- : datif (relation)
-ðei- : comitatif (relation)
-ën- : illatif (mouvement vers)
-fu- : intratif (emplacement)
-ili’- : partitif (sémantiques)
-li- : allatif (mouvement vers)
-ňo- : révertif (état)
-ńþ- : aversive (relation)
-oiþyd- : essif (temps)
-ŕo- : inessif (emplacement)
-a : absolutif (alignement morphosyntatique)
-aens : terminatif (mouvement vers)
-akļ : initiatif (mouvement depuis)
-amp : limitatif (temps)
-be : distributif-temporel (relation)
-dļ : instrumentatif (alignement morphosyntatique)
-eg : terminatif (déplacement vers)
-ei : adverbial (état)
-ek : pluriel
-eň : instructif (alignement morphosyntatique)
-etur : identique (état)
-ëd : essif-formel (état)
-igni : temporel (temps)
-in : translatif (état)
-iţ : sublatif (mouvement vers)
-jo : ergatif (alignement morphosyntatique)
-la : latif (mouvement vers)
-ły : élatif (déplacement depuis)
-ńt : équatif (état)
-oby : causal (relation)
-oit : comparatif (état)
-og : latif (mouvement via)
-öd : essif-formel (état)
-ŗeß : oblique (alignement morphosyntatique)
-ŗwo : semplatif (relation)
-uß : postessif (emplacement)
-u’ug : essif-modal (état)
-vo : accusatif (alignement morphosyntatique)
-wa : vocatif (état)
-ykń : élatif (mouvement depuis)
-źu : accusatif (temps)
